
BBBBBBBBBBBBBBBBBBBBBBBBBBBBBBBBBBBBBBBBBBBBBBBBbbbbbbbbbbbbbBBBBBBBBBBBB
BBBBBBBBBBBBBBBBBBBBBBBBBBBBBBBBBBBBBBBBBBBBBBBBbbbbbbbbbbbbbBBBBBBBBBBBB
BBBBBBBBBBBBBBBBBBBBBBBBBBBBBBBBBBBBBBBBBBBBBBBBBBBBBBBbbbbbbbbbbbbbBBBBB
b-----------------------------------------------------------------------b
b-----------------------------------------------------------------------b
b-----------------------------------------------------------------------b
b------------------------------k-------------k--------------------------b
b---------------------k-------------------------------------------------b
b----------------------------i---------------s-----i--------------------b
b------------k---------------b----------b----s----bb------k-------------b
b------------------bb----------------------------------------------lllllb
b---------------------------------------------------------s--------l----b
b--------bbb----------------------------------------------s--------l--f-b
b-a------bb-----------------------------------------------s--------l--b-b
BBBBBBBBBbb--------------------------------------------------------BBBBBB
BBBBBBBBBBBssssssssssssssssssssssssssssssssssssssssssssssssssssbbbbBBBBBB
BBBBBBBBBBBBBBBBBBBBBBBBBBBBBBBBBBBBBBBBBBbbbbbbbbbbbbbBBBBBBBBBBBBBBBBBB
BBBBBBBBBBBBBBBBBBBBBBBBBBBBBBBBBBBBBBBBBBBBBBbbbbbbbbbbbbbBBBBBBBBBBBBBB
-------------------------------------------------------------------------
-------------------------------------------------------------------------
-------------------------------------------------------------------------
-------------------------------------------------------------------------
