------------------------------------------------------------
------------------------------------------------------------
------------------------------------------------------------
BBBBBBBBBBBBBBBBBBBBBBBBBBBBBBBBBBBBBBBBBBBBBBBBBBBBBBBBBBBB
BBBBBBBBBBBBBBBBBBBBBBBBBBBBBBBBBBBBBBBBBBBBBBBBBBBBBBBBBBBB
BBBBBBBBBBBBBBBBBBBBBBBBBBBBBBBBBBBBBBBBBBBBBBBBBBBBBBBBBBBB
b-----------------------------b----------------------------b
b-----------------------------b----------------------------b
b-----------------------------b----------------------------b
b------------------b----------b----------------------------b
b------------------b-------k--b----------------------------b
b----------b-------b----------l------------------s-------f-b
b-a--b-------------b----------l----i--------i----s-------b-b
BBBBBBBBBBBBBBBBBBBBBBBBBBBBBBBBBBBBBBBB--BBBBBBBBBBBBBBBBBB
BBBBBBBBBBBBBBBBBBBBBBBBBBBBBBBBBBBBBBBBssBBBBBBBBBBBBBBBBBB
BBBBBBBBBBBBBBBBBBBBBBBBBBBBBBBBBBBBBBBBBBBBBBBBBBBBBBBBBBBB
BBBBBBBBBBBBBBBBBBBBBBBBBBBBBBBBBBBBBBBBBBBBBBBBBBBBBBBBBBBB
------------------------------------------------------------
------------------------------------------------------------
------------------------------------------------------------
------------------------------------------------------------
